........R..........E......................................L
........R.................................................L
........R........B.C.g....................................L
........R.......lmmmmmr......E..........E.................L
........R....................G....o.BC....o...............L
........R................lmmmmmmmmmmmmmmmmmmr.............L
........R...E...@..................e......x..............CL
........R...B..........C.....G...........xxx.......g....CCL
mmmmmmmmmmmmmmmmmmmmmmmmmmmmmmmmmmmmmmmmmmmmmmmmmmmmmmmmmmmmmmmmmmm