........R................................L
........R................................L
........R................................L
........R...........E.............E......L
........R....E......G...........B...g....L
........R.....G...lmmr........lmmmmmmr...L
........R...lmr...........x......@.......L
........R..G....x.....o..xx..g.......B...L
mmmmmmmmmmmmmmmmmmmmmmmmmmmmmmmmmmmmmmmmmmmmmmmmmm