........R................................L
........R................................L
........R................................L
........R...........E.............E......L
........R................................L
........R.........lmmr........lmmmmmmr...L
........R...lmr..................@.......L
........R.......###......................L
mmmmmmmmmmmmmmmmmmmmmmmmmmmmmmmmmmmmmmmmmmmmmmmmmm