****************
****************
****************
****************
****************
**********####**
****###*********
*@******###*****
****************