........R................................L
........R................................L
........R................................L
........R...........E.............E......L
........R....E......G...........B...g....L
........R.....G...lmmr...T....lmmmmmmr...L
........R...lmr.................@.......L
........R..G..........G...g..........B...L
mmmmmmmmmmmmmmmmmmmmmmmmmmmmmmmmmmmmmmmmmmmmmmmmmm