................
................
................
................
................
..........lmmr..
....lmr.........
.@......###.....
mmmmmmmmmmmmmmmm