................
................
................
............E...
................
..........lmmr..
.@..lmr.........
........###.....
mmmmmmmmmmmmmmmm