................
................
................
.@..........E...
................
..........lmmr..
....lmr.........
........###.....
mmmmmmmmmmmmmmmmmmmmmmmmmmmmmmmmm